####################################
# .................................#
#.#################.################
#..................................#
#....###.###############...........#
#......#.#.........................#
#....###.###############...........#
#..................................#
####################################